1111111111111111111111111111111111111
1P000000000000000000000000000000000C1
10E0000000000IIIIIII0IIIIIIIIIIIIIII1
1000000000IIIIIIIIC00IIII000IIIIIIII1
10000000IIIIIII0C0000I000C00IIIIIIII1
10000IIIIIIIIC00000000000000IIIIIIIC1
100IIIIIIIC00000000000000IIIIIIII0001
10IIIIIIC00000000000000IIIIIII0000001
10IIIICCCCCCC0CCCCCC0IIIIIII000000001
10IIIIIIIIIIIIIIIIII0IIIIIII00000III1
10IIIIIIIIIIIIIIIIII0IIIIIII000IIIII1
1000000000000IIIIIII0IIIIIII0IIIIIII1
100C000000000IIIIIII00000000000000001
10000000000C0IIIIIII0000000C000000001
1111111111111111111111111111111111111
