11111111111111111111111111111111111111111111111111111111111111111111111111111111111
1P000000000000000000000000000000000C00000000000000000000000000000000C0000000I0000C1
10E00000000001111111011111111111111100000011111111111101111111111111100000C00000001
100000000011111111C0011110001111111100000011100000011101110000000000000000000C00001
1000000011111110C00001000C001111111100000011100000000C011100000000000000C0000000001
1000011111111C000000000000001111111C0000001110C0000000011100C0000000000000000C00001
1001111111C0000000I0000001111111100000000011100000000I0111C000000000C000000000000C1
10111111C00000000000000111111100000000C000111111111111011100000000C000000I000000001
101111CCCCCCC0CCCCCC011111110000000I0011001111111111110111C000011111100000000C00001
101111111111111111110111111100000111000000000000000111011100I0001111100000000000001
1011111111111111111101111111000111110000000000C000011101110000000C11100000000000001
100000000I00011111110111111101111111000C0011100000011101110CCC0000111000C000C0000C1
100C000000000111111100000000000000C000000011111111111101111111111111100000000000001
10000000000C011111110000000C0000000I000000000000000000C000000000000000000000C000001
11111111111111111111111111111111111111111111111111111111111111111111111111111111111
