11111111111111111111111111111111111111111
1P000000000000000000000000000000000000001
10000000000000000C000000000000000C0000001
10000000000000000000000000000000000000001
11111111111111111111111110000C00001111111
10000000000000000000001110111111111111111
1000IIIIIIIIIII00000001110111111111111111
1000000000IIIIIIIII0001110111111111111111
1000IIIIIIIIIIIII000001110011111111111111
10000IIIIIIIIIIIII00001100011111111111111
10I0000000IIIIIII000001101111111111111111
100000IIIIIIIIIII000000001111111111111111
10I000000000000000000E1111111111111111111
11111111111111111111111111111111111111111
