1111111111111
10010000000C1
10000111110i1
1P0011e000001
1111111111111
