11111111111111111111111111111111111111
10010000000C00000000000000000000000001
11000111101100000000000000000000000001
1P1011E0000000000000000000000000000001
11000111101100000000000000000000000001
11111111111111111111111111111111111111
