1111111111111111111111111111111111
10000000000000C00000C0000000000011
1111010100100000101001111111010101
1110010010101010001001C1000001C111
1P0000000C00C0000000000E0000000C11
1111111111111111111111111111111111
