1111111111111111111111111111111111
1E000000000000C00000C0000000000011
1111010100100000101001111111110101
1110010010101010001001C0000001C111
1P1000000C00C000000000000000000C11
1111111111111111111111111111111111
