1111111111111111111111111111111111
100000000000000C00000C000000000001
1010010100100000101001000000010101
1010010010101010001001000E00010101
1P0000000C00C0000000000000000000C1
1111101111111111111111111111111111
111110111C11110C1111111111C1111111
1111101110111101111111111101111111
1111101110111101111111111101111111
1111101110111101111111111101111111
1111101110000000000000000001111111
1111101111111111111111111101111111
1111101111111111111111111101111111
1111100000000000000000000001111111
1111111111111111111111111111111111
