111111111
1P0000001
100C00001
100000E01
111111111
