11111111111111111111111111111111
10010000000C00000000000C00000001
11000111101100000000000C00000011
1P0011E0000000000000000000100101
11000111101100000000000000000001
11111111111111111111111111111111
