111111111111111111111111111111111
1E000000000000C00000C000000000001
111101010010000010100111111111011
1110010010101010001001C0000001C11
1P0000000C00C000000000000000000C1
111111111111111111111111111111111