1000000111111
000000000000
1111111111111
111111111111111
